0,0,0,0,0,0,0,0
0,0,0,0,0,0,0,0
0,10,9,9,9,9,11,0
0,7,4,4,4,4,6,0
0,7,4,4,4,4,6,0
0,7,4,4,4,4,6,0
0,7,4,4,4,4,6,0
0,12,8,8,8,8,13,0
